111111111111111111111111111111111111111111111111111111111111
130202020202020202020202020202020202020202020202020202020031
100000000000000000000000000000000000000000000000000000000001
120111110011111201111111111111111111111111120111110011111201
100120202020201002020202020202020202020202000120202020201001
120100000000001200000000000000000000000000020100000000001201
100020011110200001111111111111111111111111100020011110200001
120000011110000201111111111111111111111111120000011110000201
100120202020201002020202020202020202020202000120202020201001
120100000000001200000000000000000000000000020100000000001201
100111110011111001111111111111111111111111100111110011111001
120202020202020202020202020202020202020202020202020202020201
100000000000000000000000000000000000000000000000000000000001
120111111111111111111001001001100100100111111111111111111201
100202020202020202020201201201120120120202020202020202020001
120000000000000000000001001001100100100000000000000000000201
100111111111111111111001001001100100100111111111111111111001
120120202020202020201202001202020120200102020202020202001201
100100000000000000001000001000000100000100000000000000001001
120120111111111111201201201201120120120120111111111111201201
100100120202020202001001001001100100100102020202020201001001
120120100000000000001201201201120120120100000000000001201201
100100120111111111202020202020202020202020111111111201001001
120120100111111111000000000000000000000000111111111001201201
100100120111111111111111001110011100111111111111111201001001
120120100111111111111111201000000120111111111111111001201201
100100120111111111111111001000000100111111111111111201001001
120120100111111111111111201000000120111111111111111001201201
100100120111111111111111001111111100111111111111111201001001
120202020202020202020202000000000000202020202020202020200201
100000000000000000000000000000000000000000000000000000000001
120111111111111111111111001111111100111111111111111111111201
100202020202020202020202020202020202020202020202020202020001
120000000000000000000000000000000000000000000000000000000201
100111111111001111111111111110011111111111111100111111111001
120202020201201202020202020202020202020202020120120202020201
100000000001001000000000000000000000000000000100100000000001
120111111201201201111111111111111111111111120120120111111201
100202001000001001111111111111111111111111100100000120202001
120000001200201201111111111111111111111111120120020100000201
100111001001001001111111111111111111111111100100100100111001
120111001001001001111111111111111111111111100100100100111201
100202020202020202020202020201120202020202020202020202020001
120000000000000000000000000001100000000000000000000000000201
100111111111111201111111111201120111111111120111111111111001
120111111111111001111111111001100111111111100111111111111201
100111111111111201111111111201120111111111120111111111111001
120202020202020001111111111001100111111111100202020202020201
100000000000000201111111111201120111111111120000000000000001
120111110011111001111111111001100111111111100111110011111201
100120202020201202020202020202020202020202020120202020201001
120100000000001000000000000000000000000000000100000000001201
100020011110200201111111111111111111111111120020011110200001
120000011110000001111111111111111111111111100000011110000201
100120202020201202020202020202020202020202020120202020201001
120100000000001000000000000000000000000000000100000000001201
100111110011111001111111111111111111111111100111110011111001
100202020202020202020202020202020202020202020202020202020001
130000000000000000000000000000000000000000000000000000000031
111111111111111111111111111111111111111111111111111111111111